......#G#
...P....W
#.......#
W...#....
.........
S.P..W...
